50 50
--------------------------------------------------
--------------------------------------------------
--------------------------------------------------
--------------------------------------------------
wwwwwwwwwwwwwwwwwwwwwwwwwwwwwwwwwwwwwwwwwwwwww----
--------------------------------------------------
--------------------------------------------------
--------------------------------------------------
--------------------------------------------------
----wwwwwwwwwwwwwwwwwwwwwwwwwwwwwwww----wwwwwwwwww
----w--------------w----------fffffw--------------
----w--------------w----------fffffw--------------
----w--------------w----------fffffw--------------
----w--------------w----------fffffw--------------
----w----wwwwww----w---------wfffffw--------------
----w---------w----w---------wfffffw--------------
----w---------w----w---------wfffffw--------------
----w---------w----w----wwwwwwwwwwww--------------
----w---------w----w----ww---------w--------------
----w---------w----w----ww---------w--------------
----w---------w----w----ww---------w--------------
----w---------w----w----ww---------w--------------
----w---------w----w----ww----w----w--------------
----w---------w----w----ww----w----w--------------
----w---------w----w----ww----w----w--------------
----w---------w----w----ww----w----w--------------
----w---------w----w----------w----w--------------
----w---------w----w----------w----w--------------
----w---------w----w----------w----w--------------
----w---------w----w----------w----w--------------
----w---------w----wwwwwwwwwwww----w--------------
----w---------w--------------------w--------------
----w---------w--------------------w--------------
----w---------w--------------------w--------------
----w---------w--------------------w--------------
----w----w----wwwwwwwwwwwwwwwwwwwwwwwwwwwwwwww----
----w----w-----------------------------------w----
----w----w-----------------------------------w----
----w----w-----------------------------------w----
----w----w-----------------------------------w----
----w----wwwwwwwwwwwwwwwwwwwwwwwwwwwwwwww----w----
----w----w-----------------------------------w----
----w----w-----------------------------------w----
----w----w-----------------------------------w----
----w----w-----------------------------------w----
----w----w----wwwwwwwwwwwwwwwwwwwwwwwwwwwwwwww----
---------w----------------------------------------
---------w----------------------------------------
---------w----------------------------------------
---------w----------------------------------------
1 1
28
B 9 3 U
B 21 0 U
B 33 3 U
B 45 0 U
B 15 8 U
B 27 5 U
B 3 9 L
B 16 10 U 
B 24 16 U
B 40 34 U
B 44 10 U
B 49 15 L
B 0 21 L 
B 13 22 L
B 18 23 L
B 27 29 U
B 28 18 U
B 5 28 L 
B 36 28 L
B 3 33 L
B 13 34 L
B 25 34 U 
B 25 36 U
B 41 44 U
B 0 45 L
B 10 45 L
B 21 49 U
B 45 49 U